11111111111111111111111
10P00000010000000100001
1000000001000000000E001
100000000X000000C111111
10000000010000000000001
10000000010000000000001
1000000C0000000C0000001
11111111111111111111111