11111111111111111111111
100000C001000000010P001
10001000010000011000001
1000010001000000C010001
10010010010000110010001
10010010010000000100001
100100EC1001100C0010001
10001010100000000011011
1111100C101100001000101
11111111111111111111111